HHHHHHHHHHHHHHHHHHHHHHHHHHHHHHHHHHHHHHHHHHHHHHHHHHHHHHHHHHHHHHHHHHHHHHHHHHHHHHHHHHHHHHHHHHHHHHHHHHHHHHHHHHHH  
H                                                                                                          H  
H   00000                                                                                                  H  
HHHHHHHHHHHHHHHHHHHHHHHHHHHHHHHHHHHHHHHHHHHHHHHHH                0               000         00          00H  
H                                                H 0 HHHHH  HHHHHHHHHHH   HHHHHHHHHHHHHHHHHHHHHHHH      HHHH  
H                                                HHHHHH                                           H     H  H  
H                                                   HHH    0                                              0H  
H   0                0                               HHHHHHHHHHHHHHHHHHHHHHH                         HHHHHHH  
HHHHHHHH  H  HHHHHHHHHHHHH   HHHHHHHHHHHHHHHHH                                                     HHHH    H  
H                                            HH                                                HHHHHHWWWWWWH  
H                                                 0HH                                    HHHHHHHHHHHHHHHHH H  
H     H       H         H       H                 HHH                                HHHHHHHHH             H  
HHHHHHHHHHHHHHHHHHHHHHHHHHHHHHHHHHHHHHHHH        HHHH                          HH    HHHHH                 H  
H 0000                                       0                             HHHHHHH            000          H  
H                                            HH                          HHHHHHHHH                         H  
H                                            HH                       HHHHHHHHHHHHHHH                 00   H  
HHHHHHHHHHHHHHHHHHHHHHHHHHHHHHHHHHHHHHHHHHHHHHHHHHHHHH          HHHHHHHHHHHHHHHHHHHHHHHHHHHHHHHHHHHHHHHHHHHH  
H                                                         H        00                                 0000 H  
H    0000                                                 H                            000                 H  
HHHHHHHHHHHHHHHHHHHHHHHHHHHHHHHHHHHHHHHHHHHHHHHHHHHHHHHHHHHHHHHHHHHHHHHHHHHHHHHHHHHHHHHHHHHHHHHHHHHHHHHHHHHH  
